1::15::11
# # # # # #
#         #
# # # # # #
# * * * * # 
# # # # # #
# * * * * #
# # # # # #
# * * * * #
# # # # # #
#         #   
# # # # # #
# * * * * # 
# # # # # #
#         #
# # # # # # 